###################
#d  d         d  d#
#                 #
#RRRRRRRRRRRRRRRdR#
#RPRRRRRRRRRRRRRdR#
#RPRRRRRRRRRRRRRdR#
#RPRRRRRRRRRRRRRdR#
#RRRRRRRRRRRRRRRdR#
#RRRRRRRRRRRRRRRdR#
#RRRRRdRRRRRRRRRdR#
#RRRRRRRRRRRRRRddR#
#RRRRRRRRRRRRRRRdR#
#ddRRRRRRRRRRRdRdR#
#ddddddddddddddddR#
#RRRRRRRRRRRRRRRdR#
#RRRRRRRRRRRRRRRdR#
#dRRRRRRRRRRRRRRdR#
#dRRRRRRRRRRRdRRdR#
#ddddddddddddddddR#
###################
