###################
##PR ####d#######d#
###R#####R#######R#
#PPPPPPPPPPPPPPPPP#
#PPPPPPPPPPPPPPPPP#
################PP#
##RRR#####dP#dR#PP#
#R###R####R###R#PP#
#RRRRR###PPPPPP#PP#
#R###R##PPPPPPP#PP#
##RRR##PP#######PP#
######PP#  #####PP#
#####PP## Rd####PP#
####PP####R#####PP#
###PP#####R#####PP#
##PP######R#####PP#
#PP##R####R#####PP#
#PPPPPPPPPPPPPPPPP#
#PPPPPPPPPPPPPPPPP#
###################
LEVELNAME central-line
AUTHOR nigel
