###################
#P#RR           #R#
# #ddd##RRR      d#
# ## # RRRRR#   # #
#     dRRRR#    # #
# #####RRR##### # #
# # R  #R##  dR## #
# # #R #R##dR d d #
#    # #RR#d#R ## #
## ###  ddd  #d#d #
#   #   RR    #####
#   #R  ##R    #RR#
#   #RR  ##d    dd#
#   #dRR R#R   ## #
#  #  ##dR##R ##  #
#  # R  d#  # d#  #
#    ##### ###### #
#  ####           #
#               ###
###################
LEVELNAME clef-u-tran
AUTHOR jim
