###################
#RRRR#            #
#RRR#  ########## #
#RR#  ###RRRRR### #
#R#  #   ddddd  # #
#R# #  ########## #
#d  # #R######### #
# ### #R#RR       #
# ### #R#dd########
# ### #R# ##R# dRR#
# RRR #R# #dd#  dd#
#ddddd#R# RR  RR P#
# ###R#R# ####R####
#    R#R#   R R   #
# RRR##d##RdR##R  #
# ### #d#R#Rd  #R #
#d     d dR#  P # #
# #   #d# d  # RRR#
# #    d dR ##ddR##
###################
LEVELNAME flaps
AUTHOR jim based on an idea by nigel
