###################
##   RRRRRRRR    ##
#   RRRRRRRRRR   ##
## ddddddddddddd ##
#                 #
##               ##
#                 #
##               ##
#                 #
##R             R##
##dd           dd##
##R             R##
##dd           dd##
##   R#######R   ##
##  R#########R  ##
#  R####RR#RR##R  #
# R#####dd#dd###R #
# #######d#d##### #
#d  P     #  P ddd#
###################
LEVELNAME gizza-pyramid
AUTHOR nigel
