###################
# #d##R   R##ddddd#
#   #dd#d#dd#RdRdR#
# # ## #d# ##RRRRR#
# # #  #d#  #RRRR##
# # #d #d# R#RRR# #
#R# ## #d# ##RR#  #
#d#         #d#   #
#RP#        #     #
#R#R#       #d    #
#R#R     P  # R   #
#d dd#      # #   #
######     R# #   #
#R#        ## #   #
#R#   R##         #
#d#   #R##### #####
#     #R# d # #R#d#
# # #  d#ddd#  d  #
#d# ###   d #d#####
###################
LEVELNAME intro-duck
AUTHOR jim
