###################
#               R #
# #   ###  ##   d #
# #   #   #  #    #
# #   ##  #      d#
# #   #   #  #    #
# ### ###  ###  d #
#                 #
# ###### ######  d#
# ###### ######   #
#   ##     ##   d #
#   ##     ##     #
#   ##     ##    d#
#   ##     ##     #
#   ##     ##   d #
#   ##     ##     #
# ######   ##    d#
# ######   ##    ##
#      P         d#
###################
LEVELNAME legit
AUTHOR jim
