###################
#  R              #
# ddd #########R  #
#   ### ##     d# #
#   #R#P R #   ##d#
# d #R###R#P## #P##
#d#d#R#R#R#R    R##
#####d#d#R#R## #d##
#d#d  R #d#RdR #RP#
#R ##dRdR #d Rd#R##
#R###RP#R##### ddd#
#RP##R##d     #####
#R#  d####### #d  #
#d   #RRRRRR# ### #
#d#  #RRRRRR# # PR#
#d#   #R##R#   ##R#
#d# #  d  d  #   d#
####### ## ########
#      P  P       #
###################
LEVELNAME nine-lives
AUTHOR jim
 
