###################
#R#Rd#Rdd#  R  R  #
#R#R##R ## R#dd#R #
#d d#R# ## ###### #
#d#  dP     #  #  #
### # ## #  #  #  #
#d R# #Rd# ###### #
#d#R# #d #  #RR#  #
#d#R# #dR#   dd   #
###R#   d# ###### #
#  d## Rd#d  ##  d#
# ##  R##### ## ###
#RdR #R#     ##   #
#d Rd#d# #####  R #
#dddd#   #dR   RRd#
## ##### ##R## #Rd#
#dR# #R#  Rd#  ## #
##R# ### #R#  #d  #
##d      #d  #dd# #
###################
LEVELNAME octothorpe
AUTHOR jim
