###################
#              R  #
#d##d##d##d##d##  #
# R# R# R# R# R#d #
#PR#PR#PR#PR#PR#  #
# ## ## ## ## ##  #
#             #  d#
#     RR      # dd#
#    R##R    R# #d#
#   R#RR#R  R## ###
#R  #dddd#R #R# #d#
##R  ###  # #R# dd#
#R#R        #dd #d#
#dd#R       #d# ###
# #R#R     R### #R#
# #dd#R   R#RR# #R#
#   #R#  R#dddd  d#
## ##d#  ###### #d#
#P              #d#
###################
LEVELNAME reciprocate
AUTHOR jim
