###################
#            RdR  #
# ###########RRR# #
# #dRRRRRR#R#RRR# #
# #ddddddd d #d## #
# ######d###R     #
#   R R    #R#    #
# ###d#d#d#RR#    #
# ##RR#dRdddd#R#  #
# ##RR######d#R## #
# # dd  P   R R # #
# ##########d####d#
#dd#d#RdddRddddddd#
##ddd#Rd####d#RRRd#
#Rd#R##dRdddddRRRd#
#Rd#d###R##d#d#RRd#
#RdddddRd##d#d#RRd#
###d#R#R###d#d###d#
#ddddd#ddddd#dd#dd#
###################
LEVELNAME rock-roll
AUTHOR jim
