###################
#R##     #R##     #
#dd# ### #dd# ### #
# ##   # # ##   # #
#      # #      # #
###      ###      #
# ##  #### ##   ###
#dd# ##d #RR#  #d##
#Pd  R  d#PR  R   #
#####R########R####
#####R########R####
#R## R   #R## R   #
#dd####R #dd##### #
# #   #Rd# #    # #
#     ##d#      # #
###      ###      #
# ##   #d# ##   ###
#dR# ###d#RR#  #d##
#Pd  #   #Pd  R   #
###################
LEVELNAME speccy-4-eyes
AUTHOR jim
