###################
#RRd#   #R#ddRRRRR#
#Rdd#d#  d ##RdRdd#
#d#######R  ##RR###
#R#   #R## R#RR#RR#
#d  #  dd# ##RRdRR#
# # ######  #RR Rd#
# #   P   d #RR#Rd#
# ########R #dR## #
#  #      # ##d   #
## R    # #  # ####
####d   #  R      #
#RR# d  ######  ###
#RR#   d dR  #R   #
#dd#  d#  R# #RR  #
#dd#  #  Rd# #R#R #
#dd# #  RR##  R # #
#dd# # R#R#####d# #
#    #d# R        #
###################
LEVELNAME tidy-bag-blues
AUTHOR jim
