###################
#            #R R #
# ###R###### ddd# #
# RRRRRRR   ####  #
# dddddddd       d#
######### #########
#                 #
##R##############R#
##R###   dddd  P#d#
##d#d# ##RRRR#### #
##R#d# ########## #
#ddd              #
##d# ##############
#  #              #
# ##d# ##########R#
# R#d# ##RRRR####d#
#dR###   dddd  d# #
#dd############## #
#dd               #
###################
LEVELNAME rock-roll
AUTHOR jim
